"################################################################\n" + 
"#                                                              #\n" + 
"#                                                              #\n" + 
"#                                                              #\n" + 
"#                                                              #\n" + 
"#                                                              #\n" + 
"#                                                              #\n" + 
"#                                                              #\n" + 
"#                                                              #\n" + 
"#                                                              #\n" + 
"#                                                              #\n" + 
"#                                                              #\n" + 
"#                 $ $ $ $ $ $                                  #\n" + 
"#t&tttttttttttttttttttttttttttttttttttttttttttttttttttttttttttt#\n" + 
"#                                                              #\n" + 
"#                                                              #\n" + 
"#ttttttttttttttttttttttttttt&tttttttttttttttttttttttttttttttttt#\n" + 
"#                                                              #\n" + 
"#                                                              #\n" + 
"#                                                              #\n" + 
"#                                                              #\n" + 
"#                                                              #\n" + 
"#                                                              #\n" + 
"#                                                              #\n" + 
"#                                                              #\n" + 
"#                   #        #                                 #\n" + 
"#                    #......#   @                              #\n" + 
"#                    ########                                  #\n" + 
"################################################################"