"####t###############################################################t###\n" + 
"#                                                                      #\n" + 
"#                                t...   ...t                           #\n" + 
"#                                 tttt&tttt                            #\n" + 
"#                                t $  &  $ t                           #\n" + 
"#                                                                      #\n" + 
"#                                                                      #\n" + 
"#                                                                      #\n" + 
"#                                                                      #\n" + 
"#                                ttttt&ttttt                           #\n" + 
"#                                t         t                           #\n" + 
"#                                ttttt&ttttt                           #\n" + 
"#                                 $      $                             #\n" + 
"#                                ttttt&ttttt                           #\n" + 
"#                                t         t                           #\n" + 
"#                                t         t                           #\n" + 
"#                                t         t                           #\n" + 
"######################################&#################################\n" + 
"#                                                                      #\n" + 
"#                                 $      $                             #\n" + 
"#                                     @                                #\n" + 
"#                                                                      #\n" + 
"#                                                                      #\n" + 
"#                                                                      #\n" + 
"#                                                                      #\n" + 
"########################################################################"