"###################################################\n" + 
"#                                               @ #\n" + 
"#                                                 #\n" + 
"#  $  $  $  $                                     #\n" + 
"#                                                 #\n" + 
"#   #### ###                                      #\n" + 
"#   #......#                                      #\n" + 
"#    $    $                                       #\n" + 
"####### ## ########################################\n" + 
"#    tt&tt&tt                                     #\n" + 
"#                                                 #\n" + 
"#                                                 #\n" + 
"#                                                 #\n" +  
"#                                                 #\n" + 
"#                                                 #\n" + 
"#                                                 #\n" + 
"#                                                 #\n" + 
"#                                                 #\n" + 
"#                                                 #\n" + 
"#                                                 #\n" + 
"###################################################\n"
