"####################\n" + 
"#                  #\n" + 
"#      $ $ $ $     #\n" + 
"#####t#### #### ####\n" + 
"#      ttt&&&      #\n" + 
"#     #tt&&&t#     #\n" + 
"#    ##   @  ##    #\n" + 
"#   ###......###   #\n" + 
"################# ##\n" + 
"#              tt&t#\n" + 
"#   ########       #\n" + 
"#                  #\n" + 
"#    $    $        #\n" + 
"#                  #\n" + 
"####################\n"